1111111111111111111111111111111111111111111111111111111111111111
1000000000000000000000000000000000000000000000000000000000000001
1000000000000000000000000000000000000000000000000000000000000001
1000000000000000000000000000000000000000000000000000000000000001
1000000000000000000000000000000000000000000000000000000000000001
1000000000000000000000000000000000000000000000000000000111100001
1000000000000000000000000000000000000000000000000000000111100001
1000000000000000000000000000000000000000000000000000000001100001
1000000000000000000000000000000000000000000000000000000001100001
1000000000000000000000000111110000111110000000000000000000000001
1000000000000000000000000111110000111110000000000000000000000001
1000000000000000000000000110000000000110000000000000000000000001
1000000000000000000000000110000000000110000000000000000000000001
1000000000000000000000000110000000000110000000000000000000000001
1000000000000000000000000000000000000000000000000000000000000001
1000000000000000000000000000000000000000000000000000000000000001
1000000000000000000000000000000000000000000000000000000000000001
1000000000000000000000000000000000000000000000000000000000000001
1000000000000000000000000110000000000110000000000000000000000001
1000000000000000000000000110000000000110000000000000000000000001
1000000000000000000000000110000000000110000000000000000000000001
1000000000000000000000000111110000111110000000000000000000000001
1000000000000000000000000111110000111110000000000000000000000001
1000011000000000000000000000000000000000000000000000000000000001
1000011000000000000000000000000000000000000000000000000000000001
1000011110000000000000000000000000000000000000000000000000000001
1000011110000000000000000000000000000000000000000000000000000001
1000000000000000000000000000000000000000000000000000000000000001
1000000000000000000000000000000000000000000000000000000000000001
1000000000000000000000000000000000000000000000000000000000000001
1000000000000000000000000000000000000000000000000000000000000001
1111111111111111111111111111111111111111111111111111111111111111